++++++++
+------+
+------+
+-@@B--#
+-AAB-E+
+-C-B-E+
+-CDD-E+
++++++++