++++++++
+A--B--+
+A--B--+
+A@@B--#
+--DCCC+
+--D--E+
+--FFFE+
++++++++