++++++++
+AA---B+
+F--G-B+
+F@@G-B#
+F--G--+
+E---CC+
+E-DDD-+
++++++++