++++++++
+-ABBCD+
+-A-ECD+
+-@@E-F#
+--GG-F+
+---H--+
+---H--+
++++++++