++++++++
+------+
+------+
+@@----#
+------+
+------+
+------+
++++++++