++++++++
+--ABB-+
+-CA---+
+IC@@D-#
+IHH-D-+
+GGG-E-+
+FF--E-+
++++++++