++++++++
+AABC--+
+D-BC--+
+D@@B--#
+DEEE--+
+------+
+---FFF+
++++++++