++++++++
+--BAA-+
+--B-C-+
+-G@@C-#
+-GEED-+
+-FFFD-+
+------+
++++++++