++++++++
+--BAA-+
+--B-C-+
+-F@@C-#
+-FEED-+
+-GGGD-+
+------+
++++++++