++++++++
+ABBC--+
+A--C--+
+A@@C--#
+--EDDD+
+--E--F+
+--GGGF+
++++++++