++++++++
+FEE--A+
+F-G--A+
+@@G--A#
+--GBBB+
+----C-+
+DDD-C-+
++++++++